fa = persian
af = african
cs = Czech
en = english
hi = hindi
hu = hungarian
ja = japanese
kn = kannada
ar = arabic
ko = korean
la = latin
cy = Welsh
da = danish
ml = malay
ru = russian
mr = marathi
ne = nepali
nl = dutch
bs = bosnian
ca = catalan
et = estonian
fi = finnish
sr = serbian
it = italian
no = norwegian
hy = armanian
id = indonisian
tr = turkish
ur = urdo
pl = polish
fr = french
pt = portuguese
ro = romanian
sk = slovak
dr = germany
el = greek
lv = latvian
mk = makedonain
es = spanish
sv = swedish
zh = chinese